- Productos Dersa

Abrasivos = Abrav
Blanqueador = Blanq
Detergente en polvo = Deter_Pol
Detergente Industrial = Deter_Pol_Ind
Detergente líquido = Deter_Liq
Espojilla = Espon
Suavizante = Suav
Jabones en Barra = Jab_Bar
Lavaloza liquido = Lava_Liq
Lavaloza = Lava
Limpiador = Limp
Jabones de Tocador = Jab_Toc
Jabon liquido = Jab_Liq
Liquidos = Liq

- Marcas Dersa

Dersa
Super Nácar = Sup_Nac
Limpiador Multiusos = Limp_Mul
Dorado = Dor
Fresh = Dor_Fresh
Mio
DTerra
1A
Top terra = Top_Ter
Top Expert = Top_Exp
Top Combi = Top_Comb

- Productos Grasco

Margarina = Marg
Aceite = Acit
Mantequilla = Mant

- Marcas Grasco

Vivi
Vivi Oleina = Vivi_Ole
La fina = Fina
Mazorca de Oro = MDO

 
